{"stageNum":3,"trouble":26,"tempData":[
1,1,1,1,1,1,1,1,1,1,1,1,1,1,1,1,
1,1,1,1,1,1,5,1,0,1,1,1,1,1,1,1,
1,1,1,1,1,1,3,0,0,1,1,1,1,1,1,1,
1,1,1,1,1,0,0,0,0,3,4,1,1,1,1,1,
1,1,1,1,1,0,0,0,0,0,1,1,1,1,1,1,
1,1,1,1,4,3,0,0,0,0,1,1,1,1,1,1,
1,1,1,1,1,1,0,0,0,1,1,1,1,1,1,1,
1,1,1,1,1,1,2,0,5,1,1,1,1,1,1,1,
1,1,1,1,1,1,1,1,1,1,1,1,1,1,1,1,
1,1,1,1,1,1,1,1,1,1,1,1,1,1,1,1
],"objSize":17,"objColumn":[8,8,5,6,8,5,7,9,6,8,7,7,7,6,8,7,9],"objRow":[1,2,3,3,3,4,4,4,5,5,6,7,3,4,4,5,5],"objID":[0,1,1,1,1,1,2,1,1,2,1,2,6,6,6,6,5]}
