{"stageNum":5,"trouble":58,"tempData":[
1,1,1,1,1,1,1,1,1,1,1,1,1,1,1,1,
1,1,1,1,1,1,1,1,1,1,1,1,1,1,1,1,
1,1,1,1,1,0,0,0,0,0,1,1,1,1,1,1,
1,1,1,1,0,7,0,0,0,0,0,1,1,1,1,1,
1,1,1,0,0,0,1,1,1,1,7,0,1,1,1,1,
1,1,1,0,0,1,1,1,1,1,1,1,1,1,1,1,
1,1,1,0,0,0,1,1,1,1,0,2,1,1,1,1,
1,1,1,1,0,7,0,0,0,0,7,1,1,1,1,1,
1,1,1,1,1,0,0,0,0,0,1,1,1,1,1,1,
1,1,1,1,1,1,1,1,1,1,1,1,1,1,1,1
],"objSize":12,"objColumn":[11,7,9,3,4,3,7,9,6,8,6,8],"objRow":[4,2,2,4,5,6,8,8,2,2,8,8],"objID":[0,2,1,2,1,2,2,1,6,6,7,7]}
