{"stageNum":4,"trouble":45,"tempData":[
1,1,1,1,1,1,1,1,1,1,1,1,1,1,1,1,
1,1,1,1,1,1,1,1,1,1,1,1,1,1,1,1,
1,1,0,0,1,0,0,0,0,0,4,1,0,2,1,1,
1,1,4,0,1,0,1,1,1,1,0,1,0,5,1,1,
1,1,0,0,1,5,6,0,0,6,0,1,0,0,1,1,
1,1,0,6,1,1,6,1,1,6,1,1,6,0,1,1,
1,1,6,0,6,0,0,1,1,0,0,6,0,6,1,1,
1,1,0,6,0,0,0,1,1,0,0,0,6,0,1,1,
1,1,1,1,1,1,1,1,1,1,1,1,1,1,1,1,
1,1,1,1,1,1,1,1,1,1,1,1,1,1,1,1
],"objSize":19,"objColumn":[2,5,7,8,3,7,8,10,12,2,13,3,5,10,12,4,6,9,11],"objRow":[2,2,2,2,4,4,4,4,4,5,5,6,6,6,6,7,7,7,7],"objID":[0,4,4,4,3,4,4,4,3,3,3,3,3,3,3,3,3,3,3]}
