{"stageNum":2,"trouble":19,"tempData":[
1,1,1,1,1,1,1,1,1,1,1,1,1,1,1,1,
1,1,1,1,1,1,1,1,1,1,1,1,1,1,1,1,
1,1,1,1,1,1,1,1,1,1,1,1,1,1,1,1,
1,1,1,1,1,1,1,1,1,1,1,1,1,1,1,1,
1,1,1,2,0,0,5,0,0,0,0,5,0,1,1,1,
1,1,1,0,4,0,0,0,0,0,4,0,0,1,1,1,
1,1,1,1,1,1,1,1,1,1,1,1,1,1,1,1,
1,1,1,1,1,1,1,1,1,1,1,1,1,1,1,1,
1,1,1,1,1,1,1,1,1,1,1,1,1,1,1,1,
1,1,1,1,1,1,1,1,1,1,1,1,1,1,1,1
],"objSize":12,"objColumn":[12,7,5,8,9,10,12,3,7,8,9,11],"objRow":[5,4,4,4,4,4,4,5,5,5,5,5],"objID":[0,5,2,2,2,2,2,2,2,2,2,2]}
