{"stageNum":2,"trouble":10,"tempData":[
1,1,1,1,1,1,1,1,1,1,1,1,1,1,1,1,
1,1,1,1,1,1,1,1,1,1,1,1,1,1,1,1,
1,1,1,1,1,1,1,0,0,1,1,1,1,1,1,1,
1,1,1,1,1,0,0,0,0,0,0,1,1,1,1,1,
1,1,1,1,1,0,0,0,0,0,0,1,1,1,1,1,
1,1,1,1,1,0,0,0,0,0,0,1,1,1,1,1,
1,1,1,1,1,1,1,2,0,1,1,1,1,1,1,1,
1,1,1,1,1,1,1,1,1,1,1,1,1,1,1,1,
1,1,1,1,1,1,1,1,1,1,1,1,1,1,1,1,
1,1,1,1,1,1,1,1,1,1,1,1,1,1,1,1
],"objSize":9,"objColumn":[7,5,10,6,7,8,9,5,10],"objRow":[2,3,3,4,4,4,4,5,5],"objID":[0,1,1,2,2,3,3,4,4]}
