{"stageNum":1,"trouble":10,"tempData":[
1,1,1,1,1,1,1,1,1,1,1,1,1,1,1,1,
1,1,1,1,1,1,1,1,1,1,1,1,1,1,1,1,
1,1,1,1,1,3,0,1,0,3,1,1,1,1,1,1,
1,1,1,1,1,0,3,0,3,0,1,1,1,1,1,1,
1,1,1,1,1,1,0,3,0,1,1,1,1,1,1,1,
1,1,1,1,1,0,3,0,3,0,1,1,1,1,1,1,
1,1,1,1,1,3,2,1,0,3,1,1,1,1,1,1,
1,1,1,1,1,1,1,1,1,1,1,1,1,1,1,1,
1,1,1,1,1,1,1,1,1,1,1,1,1,1,1,1,
1,1,1,1,1,1,1,1,1,1,1,1,1,1,1,1
],"objSize":11,"objColumn":[8,6,8,5,7,9,6,8,5,7,9],"objRow":[6,2,2,3,3,3,4,4,5,5,5],"objID":[0,1,1,2,1,3,2,3,2,4,3]}
